خاک‌پاش	xAkpAS	xAkpAS
فضایح	fazAyeh	fazAyeh
خراب‌شده	xarAbSode	xarAbSode
تریتیم	teritiyom	teriti
محاولت	mohAvelat	mohAvellat
داغمه	dAqme	dAqeme
شیبانی	SeybAni	SibAni
آنتی‌توکسین	'Antitoksin	'Antitoksin
غرب‌شناسی	qarbSenAsi	qarbSenAsi
محسنی‌نسب	mohseninasab	mosaninasab
سرچسب	sarCasb	sarCasab
نوم	nom	nom
بوالحسن	bolhasan	bolhosn
ران	rAn	rAn
طیت	tiyyat	tiyat
خودکفایی	xodkafAyi	xodkafAyi
بدگوئی	badgu'i	badgu'i
قاهره	qAhere	qAhere
آب‌خشک‌کن	'AbxoSkkon	'AbxoSkkon
خاکسار	xAksAr	xAksAr
شه	Sah	Se
به‌کندی	bekondi	bekondi
افریقیه	efriqiyyeh	'ariqiyye
نابل	nAbel	nAbel
شکل	Sekl	Sekl
خوش‌الحان	xoS'alhAn	xoSolhAn
جاسوس	jAsus	jAsus
استرخا	'esterxA	'esterxA
چی	Ci	Ci
برده‌وار	bardevAr	barde
بهبهان	behbahAn	behAn
مثافنت	mosAfenat	mosAfenat
نخبه	noxbe	naxbe
سکستن	sokostan	seken
آغالشگر	'AqAleSgar	'AqAleSgar
پرستنده	parastande	parastande
دبه	dabbe	dabe
خردادی	xordAdi	xerdAdi
هوس‌کار	havaskAr	huskAr
شفوده	Sofude	Sode
ساعت‌شمار	sA'atSomAr	sA'at
نکبتبار	nekbatbAr	nekbatbAr
تونگوز	tunguz	tongo
ذره‌ذره	zarrezarre	zarre
فطور	fatur	fotur
پیکان	peykAn	pikAn
رعیت‌نواز	ra'iyyatnavAz	ra'iyyatnavAz
ابزارنگر	'abzArnegar	'bozArnegar
حیدرآبادی	heydar'AbAdi	heydar'AbAdi
پانصدم	pAnsadom	pAnsadam
عقده‌گشایی	'oqdegoSAyi	'oqdegoSAyi
آرتیستی	'Artisti	'Artisti
ضلالت	zalAlat	zalAlat
قهوه‌خانه	qahvexAne	qahuh
ناوک‌انداز	nAvak'andAz	nAvak
والعصر	val'asr	vol'asar
وشیج	vaSij	vaSij
جریش	jariS	jariS
توراتی	torAti	turAti
اخلالگر	'exlAlgar	'exlAl
نفاطون	naffAtun	nafAton
به‌طورخلاصه	betorexolAse	beturxelAse
ئی	'i	'i
شکیر	Sakir	Sakir
الیناسیون	'elinAsyun	'elinAsiyon
رضامندی	rezAmandi	rAmandi
مستحق	mostahaqq	mostahaq
تپ‌تپ	teptep	tapptap
بدیع‌الزمان	badi'ozzamAn	badi'ozzamAn
انگل	'angal	'angal
پیو	payu	piv
الکترون‌ولت	'elekteronvolt	'elekteron
مفهوم‌شناختی	mafhumSenAxti	maSnAxti
رسی	rosi	resi
انگبین	'angabin	'angabin
میر	mir	mir
شیرویه	Siruye	Siruye
شترخو	Sotorxu	Sorxo
فورمیکا	formikA	formikA
هریوه	harive	harive
پنج‌درجه‌ای	panjdaraje'i	panjdraje'i
غیردوست	qeyredust	qeyrdust
آذرپرس	'Azarperes	'Azerpars
کذاب	kazzAb	kazAb
ایده‌آلیستی	'ide'Alisti	'ide'Alisti
طرفه	torfe	tare
تراژدی‌پرداز	terAZedipardAz	terAjdipardA
لجن‌پراکنی	lajanparAkani	lajanparAkani
ناوردکنان	nAvardkonAn	nAvardkonan
سیرمانی	sirmAni	sirmAni
مستوفی	mostofA	mostofi
کپرنیک	kopernik	kornik
آیزنه	'Ayezne	'Ayzane
چهارنعل	CAhArna'l	CArna'l
همسان	hamsAn	hamsAn
حماسه‌سرایی	hamAsesarAyi	hamAsesArA
گیتی‌بان	gitibAn	giti
دری	dorri	dari
مسح	mash	mase
ساز	sAz	sAz
طنافس	tanAfes	tanAfas
شوخی	Suxi	Suxi
حاطب‌اللیل	hAtebolleyl	hAtebollil
گوردختر	gurdoxtar	gurdoxter
تاراندن	tArAndan	tArAnden
وارسی	vArasi	vArsi
هالتریست	hAlterist	hAlterist
زمخشری	zamaxSari	zamoxSari
مهیج	mohayyej	mohij
پشتبان	poStbAn	poStabAn
اجلا	'ajellA	'ojallA
جعل‌کننده	ja'lkonande	ja'alkonande
بلژیکی	belZiki	boloZiki
شکرفنده	Sekarfande	Sakarande
گربه‌سان	gorbesAn	gorbesAn
آژیدهاک	AZidehAk	'AZidhAk
ازخودگذشته	'azxodgozaSte	'azxodgozaSte
آکریدین	'Akridin	'Akridin
آچه‌ای	'ACe'i	'ACe'i
شرفانگ	SarfAng	SarfAng
روزی‌که	ruzike	ruzike
تفریحی‌سرگرمی	tafrihisargarmi	tafrisargarimi
بخون	baxun	bon
گرزان	garzAn	garzAn
صلصال	salsAl	sal
ملفوظ	malfuz	malfuz
فعل‌وانفعالات	fe'lo'enfe'AlAt	falonfa'lonaf'Al
پاک‌بین	pAkbin	pAkbin
شار	SAr	SAr
تیسر	tayassor	tisar
زیگ	zig	zig
روحی	ruhi	ruhi
جهبذ	jehbaz	jahboz
ازالت	'ezAlat	'ezAlat
غول‌پیکری	qulpeykari	qulpeykari
گراویمتری	gerAvimetri	gerAvimetri
اربعین	'arba'in	'aban
معدی	me'di	ma'di
هم‌نهاد	hamnahAd	hamnah
صنع	son'	san
تپ	tap	tep
ضبط‌صوت	zabtesot	zabtesot
خرنبار	xarambAr	xernbAr
عجایز	'ajAyez	'ajAyz
زهازه	zehAze	zahAze
دربین	darbeyne	darbin
دشواررو	doSvArro	doSvArro
نموشک	namuSak	namuSk
خزید	xazid	xazid
مرقشیشا	marqaSiSA	morqeSiSA
بناحق‌ریخته‌شده	benAhaqrixteSode	bakrixteSode
دموگرافی	demogerAfi	demogerAfi
مشروع	maSru'	maSru'
زمردنشان	zomorrodneSAn	zamardneSAn
هولوگرام	hologerAm	hologerAm
اشباه	'aSbAh	'eSbAh
تحبیب	tahbib	tahbib
لاتحصی	lAtohsA	lAtahsA
آب‌تنباکو	'AbtanbAku	'AbutanbAko
آب‌سنگ	'Absang	'Absang
باب	bAb	bA
آژ	'AZ	'AZ
بیاضی	bayAzi	biyAt
خارکنی	xArkani	xArkani
دروبطارس	darubetAres	drubtAr
نجیب‌زاده	najibzAde	najibzAde
بی‌واهمه	bivAheme	bivAheme
هلم‌جرا	halommajarrA	halmjarA
غراره	qerAre	qarA
رنگ‌کننده	rangkonande	rangkonande
دیفتری	difteri	difteri
فلخودن	falxudan	falxudan
اخوین	'axaveyn	'axin
هلسپونت	helespont	halspon
حیوانی	heyvAni	hivAni
پیونددار	peyvanddAr	piyon
باتر	bAter	bAter
مفعول	maf'ul	maf'ul
آداب‌دانی	'AdAbdAni	'AdAni
سیران	seyrAn	sirAn
پتر	petr	pter
مصطنع	mostane'	mossatan
جعل	jo'al	ja'l
فرع	far'	far'
پس‌افتاده	pas'oftAde	pas'oftAde
نیمه‌اغماء	nime'eqmA'	nime'aqmA
علامت‌دهنده	'alAmatdahande	'alAmatdahande
آرژانتینی	'ArZAntini	'ArZAntini
زریری	zariri	zariri
آوری	'Avari	'Avari
جنگلداری	jangaldAri	jang
لنجان	lenjAn	lanjAn
پهلودستی	pahludasti	pahludasti
آکومولاتور	'AkomulAtor	'AkomomolAtor
انفجاری	'enfejAri	'enfejAri
میلی‌لیتر	mililitr	militer
صفین	seffeyn	safin
استروما	'estromA	'estromA
آنوریسم	'Anurism	'Anorism
معنابخش	ma'nAbaxS	ma'nAbaxS
میله	mile	mile
زنبلغ	zambaloq	zanbalaq
نجاریان	najjAriyAn	njAriyAn
خوشایندی	xoSAyandi	xoSAyandi
تبارز	tabAroz	tabAroz
زیان	ziyAn	ziyAn
پژوهندگی	paZuhandegi	paZuhandegi
فیلفوس	filofos	fil
کلات	kalAt	kollAt
صلح‌طلب	solhtalab	solhtalab
گاوصندوق	gAvsandoq	gAvsanduq
رنگ‌زردی	rangzardi	rani
دبیر	dabir	dabir
انشعابی	'enSe'Abi	'enSe'Abi
شهلاپور	SahlApur	SahlApur
سبک‌سنگین	saboksangin	sadsangin
پوست‌آکنی	pust'Akani	pust'Akani
زرینه‌فام	zarrinefAm	zarine
مهرجویی	mehrjuyi	merjuyi
دکلان	doklAn	deklAn
تخریب‌کننده	taxribkonande	taxribkonande
فرکانس	ferekAns	ferkAns
دماکره	damAkore	domAkere
کسیلوفن	kesilofon	kesilofen
القصه	'alqesse	'alqosse
طغیانگری	toqyAngari	toqiyAngari
شوهر	Sohar	Sohar
پرماسیده	parmAside	parmAside
بشک	boSk	beSk
استه	'esteh	'aste
صادقی‌زاده	sAdeqizAde	sAdeqizAde
مرجب	morajjab	morajab
خوش‌آمد	xoS'Amad	xoS'Amad
بی‌خس	bixas	bixas
کیهان‌خدیو	keyhAnxadiv	kehAnxodiyo
غلبکین	qalbakin	qalbakin
کفائی	kafA'i	kefA'i
برژنف	bereZnef	berZenf
غوک‌جامه	qukjAme	qukjAme
بهیج	bahij	beyj
شصت‌کیلومتری	Sastkilumetri	Sastkilumetri
بی‌معرفت	bima'refat	bima'refat
پان‌ایرانیست	pAn'irAnist	pAn'irAnist
فاژیدن	fAZidan	fAZidan
هان	hAn	hAn
سرطان‌زایی	saratAnzAyi	sarAniyyi
پژوهشی	paZuheSi	paZuheSi
کارسنج	kArsanj	kArsanj
آب‌نبات‌چوبی	'AbnabAtCubi	'AbnatCubi
اهداف	'ahdAf	'ehA
عصات	'osAt	'asAt
ملک‌آرا	molk'ArA	malakArA
پرانه	parAne	parAne
مهرپناه	mehrpanAh	mehrponAh
پریر	parir	parir
احرازشده	'ehrAzSode	'ehrAzeSode
لوسانه	lusAne	losAne
شاباتی	SAbAti	SAbAti
طفل	tefl	tofl
شاه	SAh	SAh
اطاقسازی	'otAqsAzi	'etAqsAzi
بی‌درمان	bidarmAn	bidarmAn
ورتیج	vartij	vertij
ادراک‌کننده	'edrAkkonande	'edrAkkonande
گچ‌کاری	gaCkAri	gaCkAri
شیر	Sayyer	Sir
یوم‌النحر	yomonnahr	yomonnahr
شاشدان	SASdAn	SAn
پنج‌ستاره	panjsetAre	panjsetAre
چهره‌نما	CehrenamA	CerenamA
بی‌بندوبار	bibandobAr	bibandobAr
بسمله	besmele	besmele
تاثم	ta'assom	tAsem
توطن	tavatton	tutan
طاس‌باز	tAsbAz	tAsbAz
بارومتر	bArometr	bArometr
هنرسرا	honarsarA	honarsarA
نامتحرک	nAmoteharrek	nAmotaharrek
دنباله‌دار	donbAledAr	donbAle
تطلب	tatallob	talab
پرآرایش	por'ArAyeS	por'AyeS
شریعت‌نژاد	Sari'atneZAd	Sari'atenaZAd
تسلیحات	taslihAt	taslihAt
جوانی	jevAni	javAni
سیاهکاری	siyAhkAri	siyAh
مغناطیسی	meqnAtisi	moqnAtisi
کها	kahA	kehA
استراسبرگ	'esterAsborg	'esterAbg
مخزون	maxzun	maxzun
کحل	kohl	kahal
سپردنی	sepordani	sepordani
جبلهنگ	jablahang	jablhang
تعذیه	ta'ziye	ta'ziyye
چهل‌دقیقه‌ای	Ceheldaqiqe'i	Ceheldaqiqe'i
برون‌مرزی	borunmarzi	boreni
کالیده	kAlide	kAlide
تهویل	tahvil	tahiv
طریان	tarayyAn	tariyAn
غیرخردمندانه	qeyrexeradmAndAne	qeyrexordmand
واجی	vAji	vAji
ثوب	sob	sob
نفوذ	nofuz	noz
جنسی	jensi	jensi
تردماغ	tardamAq	terdmAq
غارتگری	qAratgari	qArategari
ارجا	'erjA	'rejA
زمهریر	zamharir	zamharir
اکتسابی	'ektesAbi	'ektesAbi
غیرقابل‌اعتماد	qeyreqAbele'e'temAd	qeyreqAbele'e'temAd
پارالل	pArAlel	pArolle
کامجوئی	kAmju'i	kAmju'i
عرعر	'ar'ar	'ar
بشنج	beSanj	baSanj
وحیدیه	vahidiyye	vahidiyye
یونید	yunid	yunid
گریخت	gorixt	gorixat
وطات	vat'at	vetAt
کوردلی	kurdeli	kurdeli
زربفت	zarbaft	zarbaft
علمدار	'alamdAr	'alamdAr
عالم	'Alam	'Alam
واکنشی	vAkoneSi	vAkoneSi
آرترولوژی	'ArteroloZi	'ArteroloZi
کردتبار	kordtabAr	kardtabAr
دوبلین	dublin	dobelin
نان‌وپنیر	nAnopanir	nAnopaniz
ملوک‌الطوایف	molukottavAyef	malukottavAyef
پین	pin	pin
وافوری	vAfuri	vAfuri
نگریسته	negariste	negariste
سرقت‌شده	serqatSode	serqatSode
غیرانقلابی	qeyre'enqelAbi	qer'enqalAbi
برنامه	barnAme	barnAme
یالانچی	yAlAnCi	yAl
گوش‌بین	guSbin	guSbin
اکوادور	'ekvAdor	'ekvAdor
سکن	sakan	sekon
غرنب	qoromb	qoranab
اسب	'asb	'asb
بتن‌ریز	betonriz	betonriz
نیک‌محضر	nikmahzar	nikmathazar
هکذا	hAkazA	hok
کهبد	kohbod	kahbod
تکسر	takassor	taksar
فخار	fexAr	faxAr
ماژیک	mAZik	mAZik
دگر	degar	degar
عیسی‌زاده	'isAzAde	'isizAde
محمدبن‌جریر	mohammadebnejarir	mohammadebnejarir
گنبدخانه	gombadxAne	gonbadxAne
خارش	xAreS	xAreS
گمانه‌زنی	gomAnezani	gamAne
آب‌انبار	'AbanbAr	'AbAr
بدعهد	bad'ahd	bad'ahd
شرائط	SarA'et	SayA
پرستوسادات	parastusAdAt	parastosAd
تجهم	tajahhom	tajah
راه‌انجام	rAh'anjAm	rAh'anjAm
اکسیده	'okside	'okside
هیچ‌کس	hiCkas	hiCkas
ملبوس	malbus	malbus
سردوشی	sarduSi	sarduSi
ثاقب	sAqeb	sAqeb
بلغد	bolqad	bolqad
عمه‌زاده	'ammezAde	'amezAde
پالیدن	pAlidan	pAlidan
توسم	tavassom	tosm
رحلی	rahli	rehli
آرتیکل	'Artikel	'Artikel
نشاط	neSAt	natAt
سال	sAl	sAl
تارک	tArek	tArk
صبه	sobbe	sabe
بهرمانی	bahramAni	bahromAni
بلک	balak	bolak
متافیزیک	metAfizik	metAfizik
فسفرتابی	fosfortAbi	fostAbi
افراط‌گرائی	'efrAtgerA'i	'efrAt
عقبایی	'oqbAyi	'oqbAyi
مبلغ	mablaq	mobalaq
ژله	Zele	Zele
داوودی	dAvudi	dAvudi
ورق‌پاره	varaqpAre	varqpAre
سنبله	sombole	sombole
مودع	mude'	mode'
مقفل	moqaffal	moqefl
تپنکوز	tapankuz	tpankuz
بادران	bAdrAn	bAdarAn
پلیور	poliver	palivar
نای‌انبان	nAy'ambAn	nAyan
عرقی	'araqi	'arqi
ریاضت‌پیشه	riyAzatpiSe	riyAt
درنوشتن	darneveStan	darneveStan
رهابنه	rahAbene	rahAbene
پاوند	pAvand	pAnd
لشکرشکن	laSkarSekan	laSkarSekarSekarSekarSekarSekarSekar
خون‌دماغ	xundamAq	xundamAq
درده	dorde	darde
سودجویانه	sudjuyAne	sudjuyAne
طلیق	taliq	taliq
هارولد	hArold	hArod
یون	yun	yon
نامتوازن	nAmotevAzen	nAmetavAzen
دستارچه	dastArCe	dostArCe
پرتحول	portahavvol	partahul
ذاهل	zAhel	zAhel
آوردگاه	'AvardgAh	'AvardgAh
اسدیاری	'asadyAri	'asdiyAri
بازگو	bAzgu	bAzgu
تریشینوز	teriSinoz	teriSinoz
آکو	'Aku	'Aku
ره‌آورد	rah'Avard	re'Avard
تبایع	tabAyo'	tabAye'
بیفائده	bifA'ede	bifA'ede
علف‌چر	'alafCar	'alafCer
بازسان	bAzsAn	bAzsAn
ونژد	vanZad	vanZ
ارزان‌فروشی	'arzAnforuSi	'arzAnforuSi
المنت	'element	'almann
فلرزنگ	falarzang	felez
انگورپزان	'angurpazAn	'angurpAn
نارنجکی	nArenjaki	nAranjaki
آبست	'Abast	'Abast
حدقات	hadaqAt	hadaqAt
فلسفید	falsafid	folsfid
اذیال‌الناس	'ezyAlonnAs	'ezyAlonnAs
قائمیان	qA'emiyAn	qA'emiyAn
فروشگاه	foruSgAh	foruSgAh
نسک	nask	nask
بوبه	bube	bube
چرخ‌دنده	Carxdande	Carxdande
خزائی	xozA'i	xazA'i
شجاع‌الدین	SojA'eddin	SajA'eddin
اولویت‌دهی	'olaviyyatdehi	'olotiyyat
یک‌ماده‌ای	yekmAdde'i	yekmAdde'i
مایه	mAye	mAye
میله‌دار	miledAr	mile
روغ	ruq	ruq
تخسیر	taxsir	taxsir
ضرب‌خوردگی	zarbxordegi	zarbxordegi
بی‌اندازه	bi'andAze	bi'andAze
جوزجان	jozjAn	joz
دزفول	dezful	defol
فرناندز	fernAndez	fernAndez
هشت‌ومشت	haStomoSt	haSt
روسی‌الاصل	rusiyol'asl	rusal
اژدهاک	eZdehAk	'aZdhAk
کماسه	kamAse	komAse
آدم‌کشی	'AdamkoSi	'AdamkeSi
زندگی‌سوز	zendegisuz	zedegisuz
فارغ‌التحصیلی	fAreqottahsili	fAraqottahsil
فراموش‌شده	farAmuSSode	farAmuSSode
تکنیسین	teknisiyan	teknisiyan
میادین	mayAdin	myAdin
لاکتیک‌اسید	lAktikasid	lAk'asid
پرنیخ	parnix	pornix
سیسرک	sisarak	sisark
واریزنامه‌ای	vAriznAme'i	vAriznAme'i
ساخته	sAxte	sAxte
تنباکو	tambAku	tanbAku
اسپرفیت	'esporofit	'esperfit
اسفنکتر	'esfankter	'esfenketr
طویل‌القامه	tavilolqAme	tayel
ستین	settin	setin
نسخ	nosax	nasx
صلوات‌الله‌علیهم	salavAtollAho'alayhem	salAvAtollAh'alayhem
شوی‌دیده	Suydide	Savidide
پارس	pArs	pArs
جان‌گزا	jAngazA	jAngozA
خالواش	xAlvAS	xAlvAS
مهاجرانی	mohAjerAni	mohAjarAni
لطایف	latAyef	latAyef
پوی	puy	puy
کوبیدگی	kubidegi	kubidegi
حشر	haSr	haSr
صینی	sini	seyni
سرطاس	sartAs	sartAs
موزی	mozi	muzi
چهارجانبه	CAhArjAnebe	CArjAnebe
غیرارشادی	qeyre'erSAdi	qeyreSAdi
اوزون	'ozon	'ozon
عبدالرحمن‌بن‌خالدبن‌ولید	'abdorrahmAnebnexAledebnevalid	'abdolayn
غبارگیر	qobArgir	qabArgir
اسکانیا	'eskAniyA	'eskAniyA
شتربچه	SotorbaCCe	SarbaCe
گلدسمیت	goldesmit	goldsammiyyat
دروانه	darvAne	darvAne
قربان	qorbAn	qorbAn
ایستانیدن	'istAnidan	'istAnidan
اشناختن	'eSnAxtan	'eSnAxtan
جزیی‌نگر	jozyinegar	jaziye
لابه	lAbe	lAbe
ابن‌سعد	'ebnesa'd	'ebnesa'd
تصاویر	tasAvir	tasAvir
پشت‌دار	poStdAr	poSt
بتکوب	batkub	batkub
شخسار	SaxsAr	SaxsAr
عباس‌میرزا	'abbAsmirzA	'abAsmirzA
برزوبالا	borzobAlA	barzobAri
مذنب	mozanneb	mozan
پیش‌آهنگی	piS'Ahangi	piS'Ahangi
پالانی	pAlAni	pAlAni
هنگامی	hengAmi	hengAmi
خسارت‌بار	xesAratbAr	xesArat
آدم‌برفی	'Adambarfi	'Adambarfi
مهرشهر	mehrSahr	mehrSahr
بوته‌ای	bute'i	bute'i
گرچه	garCe	gorCe
فراآوردن	farA'Avardan	far'Avardan
مسرور	masrur	masrur
ایران‌دوچرخ	'irAndoCarx	'iran
خارا	xArA	xArA
فرارسید	farAresid	farArisid
تغار	taqAr	taqAr
پاره‌پاره	pArepAre	pAre
توفیق	tofiq	tofiq
شاددل	SAddel	SAdedel
خوش‌ذقن	xoSzaqan	xoSak
حسابرسی	hesAbresi	hasAbresi
زرو	zaru	zoro
پسریچه	pesariCe	pasariCe
حتمی	hatmi	hatmi
محاریب	mahArib	mahArib
اتفاقی	'ettefAqi	'ettefAqi
نیمه‌فعال	nimefa''Al	nimefa'Al
هم‌مباحثه	hammobAhese	hammAhasse
وارف	vAref	vAref
معرض	mo'rez	mo'arz
نغمه‌سرا	naqmesorA	naqmesorA
ملل	melal	malal
مطبقه	motbeqe	motabaqe
سازکرده	sAzkarde	sAzkade
کافه‌نشین	kAfeneSin	kAfeneSin
صنوبر	senobar	sanobar
ابوحسن	'abuhasan	'bohsen
خواندن	xAndan	xAndan
قابل‌تفکیک	qAbeletafkik	qAbeletafkik
گراهام	gerAhAm	gerAh
علف‌زار	'alafzAr	'alafzAr
سرگرانی	sargerAni	sargerAni
دول	dul	dul
لهنج	lahanj	lhanj
فوات	favAt	fovAt
فوق‌کلیه	foqekolye	foqekolliyyah
نوع‌دوستانه	no'dustAne	no'dustAne
روح	ruh	roh
واگذارکننده	vAgozArkonande	vAgozArkAnande
سیم‌کش	simkeS	simkeS
وجه‌الضمان	vajhozzemAn	vajheze
دست‌دوزی	dastduzi	dastde
کامل‌نشده	kAmelnaSode	kAmelnaSode
نصرالدین	nasreddin	nasreddeyn
ریشه	riSe	riSe
ربع‌قرن	rob'qarn	rob'aqaran
تحدیدکننده	tahdidkonande	tahdidkonande
بی‌مخی	bimoxi	bimaxi
وحشتناک	vahSatnAk	vaheStanAk
پورپورا	purpurA	purA
ابتداع	'ebtedA'	'ebtedA'
جلادت	jalAdat	jalAdat
آوردن	'Avardan	'Avardan
اسرافیلی	'esrAfili	'esrAfili
آرامگاهی	'ArAmgAhi	'ArAmgAhi
پنج‌گوشه	panjguSe	panjguSe
سینه‌به‌سینه	sinebesine	sine
پنج‌دقیقه‌ای	panjdaqiqe'i	panjdaqiqe'i
ازهد	'azhad	'azhad
زاهدان	zAhedAn	zAh
تاج‌خروس	tAjxorus	tAjxorus
دودخانه	dudxAne	dudxAne
شماره‌گیری	SomAregiri	SomAregiri
ایل‌بیگی	'ilbeygi	'ilbeyhi
منتن	monten	monten
مشتق	moStaqq	moSteq
انتساق	'entesAq	'entesAq
لزوم	lozum	loz
واگون	vAgun	vAgon
یادبود	yAdbud	yAdbud
پارابلوم	pArAblom	pArAbolum
مستکره	mostakrah	mostakere
ارک	'ark	'ark
درونروی	darunruy	daronravi
نخجل	naxjal	naxjal
سازش‌کارانه	sAzeSkArAne	sAzeSkArAne
کماسه‌گری	kamAsegari	komAsegari
آتیلا	'AtilA	'AtilA
اشو	'aSu	'oSo
پولادی	pulAdi	polAdi
دباغ‌پور	dabbAqpur	dabAqpur
گرداننده	gardAnande	gardAnande
تلسک	telesk	talask
ترب‌سیاه	torobsiyAh	tarabsiyyAh
اشکردن	'eSkardan	'eSkardan
کمر	kamar	kamar
بیژن	biZan	biZan
آناکوندا	'AnAkondA	'AnAkondAk
طرفین	tarafeyn	tarin
قالیچه	qAliCe	qAliCe
ردف	redf	radf
خمار	xomAr	xamAr
دهنه	dahane	dahane
زنبوران	zanburAn	zanburAn
آیدا	'AydA	'AydA
پرماه	pormAh	parmAh
شبه‌پول	Sebhepul	Sabepul
دوستی	dusti	dusti
پری‌آباد	pari'AbAd	pari'AbAd
آنکش	'AnkeS	'AnkeS
تجویزکننده	tajvizkonande	tajvizkonande
باریک‌میان	bArikmiyAn	bArikmiyAn
سردم	sardam	sardom
تباهه	tabAhe	tabAhe
بالتیک	bAltik	bAltik
پرهیخته	parhixte	parhixte
متوفی	motevaffA	motevvafi
جورابچیان	jurAbCiyAn	jurAbCiyAn
رجالی	rejAli	rejAli
خیانت	xiyAnat	xiyAnat
رئوفانه	ra'ufAne	ro'ufAne
ابرجنایتکار	'abarjenAyatkAr	'abrejnAyatkAr
گیلز	gilz	gilz
پرخاش‌کیش	parxASkiS	parxASkiS
صوابدید	savAbdid	savAbdid
سینه‌راما	sinerAmA	sinerAmA
سوئز	su'ez	su'ez
فاکتور	fAktor	fAktor
هجی	hejji	haji
غریبانه	qaribAne	qaribAne
کوچ‌نشینی	kuCneSini	kuCneSini
ریختنی	rixtani	rixtani
اشتاب	'eStAb	'eStAb
موردنظر	moredenazar	murdnazar
گسستن	gosastan	gosastan
جنفج	janfaj	jonfaj
هزارجریب	hezArjarib	hezArjarib
شکرخا	SekarxA	SekroxA
آخروعاقبت	'Axaro'Aqebat	'Axaruva'Aqebat
تازه‌اکران‌شده	tAze'ekrAnSode	tAze'okrAnSode
دیپلوکوک	diplokok	diploko
ریمل	rimel	riyomel
بسا	basA	basA
عود	'od	'ud
سانحه‌دیده	sAnehedide	sAnededide
خزل	xazl	xel
برو	boro	boru
خرمن‌سوخته	xarmansuxte	xarmansuxte
بزور	bozur	bezur
کاساب	kAsAb	kAsAb
آبتنی	'Abtani	'Abtani
استقلال‌رسیده	'esteqlAlreside	'esteqlAlraside
بلشویکی	bolSeviki	beleSviki
رو	rav	ro
آوردخواه	'AvardxAh	'AvardxAh
گنبد	gonbad	gonbad
مجتری	mojtari	mojtari
پرلود	perlud	parlud
مبالغ	mabAleq	mabAlaq
بلعکس	bel'aks	bal'aks
شایان	SAyAn	SAyAn
پشتکار	poStekAr	poStkAr
خوش‌منظره	xoSmanzare	xoSmanzare
علامتی	'alAmati	'alAmati
غیراروپائی	qeyre'orupA'i	qirAri
آزمون‌شناسی	'AzmunSenAsi	'AzmunSenAsi
پرفسوس	porfosus	perfosus
قلبی‌شکل	qalbiSekl	qaliSikol
حسبه	hesbe	hasbe
رویان	ruyAn	royAn
پایان‌پذیر	pAyAnpazir	pAyAnpazir
پسماند	pasmAnd	pasmAnd
بی‌آب	bi'Ab	bi'Ab
کویل	koyl	koyv
شش‌هفت‌ماهه	SeShaftmAhe	SSehette
قلیا	qalyA	qaliyA
جذاذه	jozAze	jazAz
دیومردم	divmardom	divmardom
بهتاش	behtAS	behtAS
پرزین	porzin	porzin
پشت‌گلی	poStgoli	poSt
ثنائی	sanA'i	sanA'i
تمثل	tamassol	tamassal
آگوتی	'Agoti	'Agoti
نیل‌گر	nilgar	nil
منایح	manAyeh	manAyeh
سرپایی	sarpAyi	sarpAyi
عشق	'eSq	'eSq
خرده‌گیری	xordegiri	xordegiri
گاومیش	gAvmiS	gAvmiS
برپاسازی	barpAsazi	barpAsAzi
جنح	jenh	jonne
ابن	'ebn	'ebn
بولشویسم	bolSevism	boSuyasm
تپش	tapeS	tapeS
گامتوفیت	gAmetofit	gAmtofit
متواطی	motavAti	motAqi
پیش‌سلام	piSsalAm	piSsalAm
واهنربا	vAhanrobA	vAhonarbA
مخاطر	maxAter	moxAter
سوگمندانه	sugmandAne	sugmand
پنیرسازی	panirsAzi	panirsAzi
بکرزایی	bekrzAyi	bekrzAyi
تشارین	taSArin	teSArin
تلاعب	talA'ob	talA'eb
تواره	tovAre	tavvAre
پیاده	piyAde	piyAde
پلور	polur	palvar
کلریدریک	koloridrik	koloridrik
بالاتیره	bAlAtire	bAlAtire
اسکیزه	'eskize	'eskize
شش‌سالگی	SeSsAlegi	SSosAlegi
میلی‌مترمربع	milimetremorabba'	milimetremorabba'
عثمانی	'osmAni	'osmAni
پوچال	puCAl	poCAl
ددر	dadar	der
غلات	qallAt	qalAt
قارچ‌ها	qArChA	qArChA
باغی	bAqi	bAqi
زرباف	zarbAf	zarbAf
سلحشوری	salahSuri	salhi
برگیر	bargir	bargi
یک‌ترمی	yektermi	yektarmi
منوساکارید	monosAkArid	monosAkArid
ولو	valo	velo
پالایش	pAlAyeS	pAlAyeS
تجمیع	tajmi'	tajmi'
خیرالله‌زاده	xeyrollAhzAde	xeyrollAhzAde
سوخت	suxt	suxt
مسئولانه	mas'ulAne	mas'ulAne
مروح	moravveh	moruh
خوابنیدن	xAbanidan	xAbanidan
پرمحتوا	pormohtavA	pormohtavA
گشت	geSt	gaSt
مرداویج‌بن‌زیار	mardAvijebneziyAr	mardAvij
روبنایی	rubanAyi	rubnAyi
لنگ‌وپاچه	lengopACe	lengopACe
دیکتاتورانه	diktAtorAne	diktAtorAne
آستروگرافی	'AstrogerAfi	'AstrogerAfi
مستاجر	mosta'jer	mostAjer
سبیلی	sabili	sebili
درنیامده	darnayAmade	darniyAmade
کمین‌گذاری	kamingozAri	kamingozAri
کارگرنشین	kArgarneSin	kArgoneSin
ضلالت	zelAlat	zalAlat
خرمنج	xarmonj	xarmanj
رپورتاژ	reportAZ	rpurpurpurpurpurpurpurpurpurpurpurpu
کازیه	kAziye	kAziyye
غریب‌القرآن	qaribolqor'An	qar'An
بزمی	bazmi	bezmi
جوشک	juSak	juSak
درهم‌پیچیده	darhampiCide	darhampiCide
اندخسواره	'andaxsvAre	'andaxsavAre
جسماً	jesman	josman
تقعیر	taq'ir	taqir
امامت	'emAmat	'emAmat
هندوکش	hendokeS	handukeS
پلی‌وینیل‌کلراید	polivinilkolorAyd	polinilkoloriy
مورچه‌گیر	murCegir	murCegir
زمانه‌ساز	zamAnesAz	zamAne
غارتزده	qAratzade	qArtzade
مشترکاً	moStarekan	moStarak
مدساز	modsAz	moddAs
اهرمن‌لاخ	'ahremanlAx	'ahram
زاروزندگی	zArozendegi	zArozandegi
بخشودگی	baxSudegi	baxSudegi
سبی	saby	sabi
هیچگرا	hiCgerA	hiCge
نایب‌رئیسی	nAyebra'isi	nAbre'isi
نصایح	nasAyeh	nasAyh
ضدکشوری	zeddekeSvari	zedekoSuri
غیرسرمایه‌داری	qeyresarmAyedAri	qersormAye
آئینه‌خانه	'A'inexAne	'AnexAne
به‌رایگان	berAyegAn	berAye
وز	vaz	vez
ارزشگرا	'arzeSgerA	'arzeSgarA
نص	nass	nas
ئیدروفیل	'idrofil	'idrofil
همدست	hamdast	hamdast
هوفاریقون	hufAriqun	hofAriqon
دیلی‌نیوز	deyliniyuz	dilini
گوپاره	gopAre	gupAre
فسرانیدن	fesorAnidan	fesdanidan
احمدشاه	'ahmadSAh	'ahamdaSAh
خواربارفروشی	xArobArforuSi	xArforuSi
امدادیان	'emdAdiyAn	'emdAdiyAn
فویلی	foyli	foyli
نقره‌سازی	noqresAzi	noqresAzi
عزت‌نژاد	'ezzatneZAd	'ezzatenAZAd
حفاظتی	hefAzati	hafAzati
آزردن	'Azordan	'Azordan
مرسی	mersi	moris
وی	vey	vi
قچ	qoC	qoC
غیرهم	qeyrohom	qeyrahhom
گزای	gazAy	gazi
قمارباز	qomArbAz	qomAr
راست‌رو	rAstro	rAstro
شگفت‌زدگی	Segeftzadegi	Segeftzadegi
کمانگیر	kamAngir	komAngir
دگردیسی	degardisi	degarisi
هوبه	hube	hube
مبذول	mabzul	mabzul
مترف	motraf	moteraf
ساقه‌بلند	sAqeboland	sAqeboland
است	'ast	'asat
کامل‌عیار	kAmel'ayAr	kAmel'ayAr
بلالی	balAli	balAli
ناخدایی	nAxodAyi	nAxAdi
لنفی	lanfi	lanfi
غیرمستعمره	qeyremosta'mere	qermosta'mar
اطایب	'atayeb	'atAyeb
ظهیرالدوله	zahiroddole	zahiroddole
بداوت	badAvat	badAvat
اوعیه	'o'iye	'oyye
دیگ	dig	dig
نیاورده	nayAvarde	niyArade
به‌همین‌منظور	behaminmanzur	behaminmanzur
خیال‌باف	xiyAlbAf	xiyAl
نیل‌فام	nilfAm	nilfAm
نقدینه	naqdine	naqdine
پرسرعت	porsor'at	porso'at
سینه‌زن	sinezan	sinezan
غیاب	qiyAb	qiyAb
خرام	xarAm	xarAm
روبیان	rubiyAn	rubiyAn
تبلیغ‌شده	tabliqSode	tabliqSode
بیرجندی	birjandi	birjendi
لیزین	lizin	lizin
آنگلوفوب	'Angelofob	'Angolofub
سپهران‌سپهر	sepehrAnsepehr	sepehr
نایپوش	nAypuS	nAypuS
فردگرائی	fardgerA'i	fardgerA'i
شماتتگر	SemAtatgar	SemAt
سوچی	suCi	suCi
برگماردن	bargomArdan	bargomArdan
ریزنقش	riznaqS	rizanqeS
اوکی	'okey	'uki
کولاک	kulak	kolAk
غازان	qAzAn	qAzAn
آکریلیک	'Akrilik	'Akrilik
متعبد	mota'abbed	mota'bad
هومر	humer	homer
بدریخت	badrixt	badrixt
سبحانی	sobhAni	sobhAni
کامفر	kAmfer	kAmefr
پی‌شناسی	peySenAsi	piSanAsi
طلقی	talqi	talaqi
جمله‌ای	jomle'i	jomelle'i
سندر	sandar	sandar
سهل‌القبول	sahlolqabul	salolqobul
سروگاه	sorugAh	sorugAh
فنائیان	fanA'iyAn	fanA'iyAn
جویده	javide	javide
عقده‌گشا	'oqdegoSA	'oqde
آرام‌آرام	'ArAmArAm	ArAm'Am
تکین	takin	takin
دفائن	dafA'en	defA'en
پرچمدار	parCamdAr	parCamdAr
یافت‌شده	yAftSode	yAftSode
زبده	zobde	zboh
خاک‌اره	xAk'arre	xAke
کفش‌کن	kafSkan	kafSkon
محبت	mohabbat	mohebbat
بندباز	bandbAz	band
نورآدرنالین	nur'AdrenAlin	nurdAleyn
کپور	kapur	kpur
جاده‌سازی	jAddesAzi	jAde
کاراکتر	kArAkter	kArAter
بی‌همتا	bihamtA	bihemmatA
زیربنا	zirbanA	zirbanA
پدیده	padide	payde
غیه	qiyye	qiyye
قراختائی	qarAxatA'i	qar'extA'i
پوشانیده	puSAnide	puSAnide
دست‌کاری‌شده	dastkAriSode	dastkAriSode
سردابه	sardAbe	sardAbe
آوا	'AvA	'AvA
انعطافی	'en'etAfi	'en'etAfi
لنینیسم	leninism	leninism
الاغ	'olAq	'olAq
قدم	qedam	qadam
لادین	lAdin	lAdin
مدحت	medhat	modhat
لجن	lajan	lajan
آبدره	'Abdarre	'Abdarre
رقم	raqam	raqam
ورزیدن	varzidan	varzidan
مهاب	mahAb	mahAb
داعی‌الدعاة	dA'iyoddo'At	dAyyodda'At
کبربا	kabarbA	kabrebA
ازاراقی	'azArAqi	'azArAqi
تستر	toster	tes
پرتکلف	portakallof	porteklof
پخزنی	paxzani	paxzani
خفقان‌آور	xafaqAn'Avar	xafaqAn'Avar
فائح	fA'eh	fA'e
دولتداری	dolatdAri	doltdAri
نزار	nazAr	nazAr
پاگودا	pAgodA	pAgudA
اصل	'asl	'asl
زیرخط	zirxatt	ziroxt
سجال	sejAl	sejAl
مهرتاش	mehrtAS	mehrtAS
کستر	kastar	kostor
پارین	pArin	pArin
تال‌ومال	tAlomAl	tAlomAl
بی‌آلایشی	bi'AlAyeSi	bi'AlAyeSi
خیسانده	xisAnde	xisAnde
یاجوج	ya'juj	yAjuj
لوله‌سانان	lulesAnAn	lule
متنبه	motenabbeh	motanabbe
چرا	CerA	CerA
خربندگی	xarbandegi	xarbandegi
خاتمیت	xAtamiyyat	xAtimi
انسان‌ساز	'ensAnsAz	'ensAnsAn
انتفاعی	'entefA'i	'entefA'i
گستاخی	gostAxi	gostAxi
اشکبوس	'aSkbus	'eSkbus
ژاژخواهی	ZAZxAhi	ZAxAhi
باغبان	bAqbAn	bAqbAn
طواف‌گاه	tavAfgAh	tavAf
فکاهت	fokAhat	fekAhat
آب‌سوار	'AbsavAr	'AbsavAr
ستیخ	setix	setix
کرز	korz	karz
مجمع	majma'	majma'
گالش	gAleS	gAleS
عمدی	'amdi	'amdi
شیربخ	Sirbax	Sirbax
سنجه	sanje	senje
مسهد	mosahhad	mosahh
هادیان	hAdiyAn	hAdiyAn
خروس‌بازی	xorusbAzi	xorusbAzi
پرانید	parAnid	parAnid
ازدست	'azdaste	'ozbot
نمیر	namir	namir
مشروح	maSruh	maSruh
تورم	tavarrom	turm
چندشکلی	CandSekli	CandSekli
تحفه	tohfe	tahaffe
جمیلی	jamili	jamili
مخاطب‌شناسی	moxAtabSenAsi	moxAtebSenAsi
باشرافت	bASerAfat	bASe
سیادت	siyAdat	siyAdat
قناسی	qenAsi	qenAsi
آلگ	'Alag	'Alg
چندپاره	CandpAre	CandpAre
کاظمی	kAzemi	kAzomi
ممارست	momAresat	morAset
کم‌فشار	kamfeSAr	kamfeSAr
سفالینه	sofAline	safAline
مجاز	majAz	mojAz
مصیبت‌بار	mosibatbAr	mosibatbAr
مزدبگیری	mozdbegiri	mozedbegiri
زیرآب	zir'Ab	zirAb
استعدادی	'este'dAdi	'este'dAdi
آب‌پرده	'Abparde	'Abparde
شالیکاری	SAlikAri	SAli
غدر	qadr	qadr
چیزک	Cizak	Cizak
تذکره‌نویس	tazkarenevis	tazkerenevis
نزیه	nazih	naziyye
باکتریایی	bAkteriyAyi	bAktiyAyi
شبینه	Sabine	Sabine
طرد	tard	tard
آسمانکان	'AsemAnkAn	'AsemAnkAn
نامنظم	nAmonazzam	nAmonzam
هیأت‌منصفه	hey'atmonsefe	hey'atmonassefe
قاسطین	qAsetin	qAsetin
خودگزین	xodgozin	xodgozin
محضالله	mahzanlellAh	mohzAlelAh
سنگاب	sangAb	sangAb
پاپیچال	pApiCAl	pACAl
کمربندی	kamarbandi	kamarbandi
مصطفایی	mostafAyi	mostafAyi
کله	kele	kole
مهچه	mahCe	mohCe
نازک‌شده	nAzokSode	nAzakSode
غفول	qoful	qoful
دیونژاد	divneZAd	divneZAd
ارجان	'arjAn	'arjAn
تاریخچه	tArixCe	tArixCe
ناخوشبختی	nAxoSbaxti	nAxoSbaxti
ختنبر	xatambar	xtanbar
دیگ‌بردیگ	digbardig	digbordig
اشتغال‌زایی	'eSteqAlzAyi	'eSteqAlzAfi
گرمایش	garmAyeS	garmAyeS
دق‌الحصیر	daqqolhasir	daqolhasir
نیتراسیون	nitrAsiyon	nitrAsiyon
شمیران	SemirAn	SamirAn
کوزه‌شکسته	kuzeSekaste	kuzeSekaste
قتاد	qatAd	qtAd
انزجارآمیز	enzejAr'Amiz	enzejAr'Amiz
پدافند	padAfand	podAfand
قشر	qeSr	qar
نوین‌سازی	novinsAzi	nivinsAzi
فرهنگنامه	farhangnAme	farhangnAme
توارثی	tavArosi	tavAresi
متعاهد	mote'Ahed	mote'Ahed
اطعمه	'at'ame	'ame
خبال	xabAl	xebAl
