خاک‌پاش	xAkpAS	xAkpAS
فضایح	fazAyeh	fazAyeh
خراب‌شده	xarAbSode	xarAbSode
تریتیم	teritiyom	teritim
محاولت	mohAvelat	mohAvelat
داغمه	dAqme	dAqeme
شیبانی	SeybAni	SibAni
آنتی‌توکسین	'Antitoksin	'Antitoksin
غرب‌شناسی	qarbSenAsi	qarbSenAsi
محسنی‌نسب	mohseninasab	mohsannesab
سرچسب	sarCasb	sarCasb
نوم	nom	nom
بوالحسن	bolhasan	bolhasan
ران	rAn	rAn
طیت	tiyyat	teyt
خودکفایی	xodkafAyi	xodkafAyi
بدگوئی	badgu'i	badgu'i
قاهره	qAhere	qAhere
آب‌خشک‌کن	'AbxoSkkon	'AbxaSkan
خاکسار	xAksAr	xAksAr
شه	Sah	Sah
به‌کندی	bekondi	bekandi
افریقیه	efriqiyyeh	'afriqiyye
نابل	nAbel	nAbel
شکل	Sekl	Sekl
خوش‌الحان	xoS'alhAn	xoSolhAn
جاسوس	jAsus	jAsus
استرخا	'esterxA	'esterxA
چی	Ci	Ci
برده‌وار	bardevAr	bardevAr
بهبهان	behbahAn	bahbahAn
مثافنت	mosAfenat	masAfenat
نخبه	noxbe	noxbe
سکستن	sokostan	sekestan
آغالشگر	'AqAleSgar	'AqAleSgar
پرستنده	parastande	parastande
دبه	dabbe	dabe
خردادی	xordAdi	xordAdi
هوس‌کار	havaskAr	havaskAr
شفوده	Sofude	Safude
ساعت‌شمار	sA'atSomAr	sA'atSomAr
نکبتبار	nekbatbAr	nekbatbAr
تونگوز	tunguz	tonguz
ذره‌ذره	zarrezarre	zarrezare
فطور	fatur	fatur
پیکان	peykAn	peykAn
رعیت‌نواز	ra'iyyatnavAz	re'yatnavAz
ابزارنگر	'abzArnegar	'abzArangar
حیدرآبادی	heydar'AbAdi	heydar'AbAdi
پانصدم	pAnsadom	pAnsadam
عقده‌گشایی	'oqdegoSAyi	'oqdegoSAyi
آرتیستی	'Artisti	'Artisti
ضلالت	zalAlat	zelAlat
قهوه‌خانه	qahvexAne	qahvexAne
ناوک‌انداز	nAvak'andAz	nAvakandAz
والعصر	val'asr	vAla'sar
وشیج	vaSij	vaSij
جریش	jariS	jariS
توراتی	torAti	torAti
اخلالگر	'exlAlgar	'exlAlgar
نفاطون	naffAtun	nafAtun
به‌طورخلاصه	betorexolAse	betorxelAse
ئی	'i	'i
شکیر	Sakir	Sakir
الیناسیون	'elinAsyun	'alinAsiyon
رضامندی	rezAmandi	rezAmandi
مستحق	mostahaqq	mostahq
تپ‌تپ	teptep	taptap
بدیع‌الزمان	badi'ozzamAn	badi'ozzamAn
انگل	'angal	'angal
پیو	payu	piv
الکترون‌ولت	'elekteronvolt	'elekteronvelt
مفهوم‌شناختی	mafhumSenAxti	mafhumSenAxti
رسی	rosi	rasi
انگبین	'angabin	'angabin
میر	mir	mir
شیرویه	Siruye	Sirviyye
شترخو	Sotorxu	Sotorxu
فورمیکا	formikA	formikA
هریوه	harive	harive
پنج‌درجه‌ای	panjdaraje'i	panjdarje'i
غیردوست	qeyredust	qeyredust
آذرپرس	'Azarperes	'Azarpars
کذاب	kazzAb	kazAb
ایده‌آلیستی	'ide'Alisti	'ide'Alisti
طرفه	torfe	tarfe
تراژدی‌پرداز	terAZedipardAz	tarAZdipardAz
لجن‌پراکنی	lajanparAkani	lajanparAkani
ناوردکنان	nAvardkonAn	nAvardkonAn
سیرمانی	sirmAni	sirmAni
مستوفی	mostofA	mostofi
کپرنیک	kopernik	kaprnik
آیزنه	'Ayezne	'Ayzane
چهارنعل	CAhArna'l	CAhArna'al
همسان	hamsAn	hamsAn
حماسه‌سرایی	hamAsesarAyi	hamAsesarAyi
گیتی‌بان	gitibAn	gitibAn
دری	dorri	dari
مسح	mash	mash
ساز	sAz	sAz
طنافس	tanAfes	tanAfos
شوخی	Suxi	Suxi
حاطب‌اللیل	hAtebolleyl	hAtebollAh
گوردختر	gurdoxtar	gurdoxtar
تاراندن	tArAndan	tArAndan
وارسی	vArasi	vAresi
هالتریست	hAlterist	hAlterist
زمخشری	zamaxSari	zamaxSari
مهیج	mohayyej	mahij
پشتبان	poStbAn	poStbAn
اجلا	'ajellA	'ajalA
جعل‌کننده	ja'lkonande	ja'lkonande
بلژیکی	belZiki	bolZiki
شکرفنده	Sekarfande	Sekarfande
گربه‌سان	gorbesAn	gorbesAn
آژیدهاک	AZidehAk	'AZidhAk
ازخودگذشته	'azxodgozaSte	'azxodgozaSte
آکریدین	'Akridin	'Akridin
آچه‌ای	'ACe'i	'ACe'i
شرفانگ	SarfAng	SarfAng
روزی‌که	ruzike	ruzike
تفریحی‌سرگرمی	tafrihisargarmi	tafrihisargarmi
بخون	baxun	boxun
گرزان	garzAn	garzAn
صلصال	salsAl	salsAl
ملفوظ	malfuz	malfuz
فعل‌وانفعالات	fe'lo'enfe'AlAt	fa'lo'enfe'AlAt
پاک‌بین	pAkbin	pAkbin
شار	SAr	SAr
تیسر	tayassor	tiser
زیگ	zig	zig
روحی	ruhi	ruhi
جهبذ	jehbaz	jahbaz
ازالت	'ezAlat	'ezAlat
غول‌پیکری	qulpeykari	qulpeykari
گراویمتری	gerAvimetri	gerAvimetri
اربعین	'arba'in	'arba'in
معدی	me'di	ma'di
هم‌نهاد	hamnahAd	hamnahAd
صنع	son'	san'
تپ	tap	tap
ضبط‌صوت	zabtesot	zabtsot
خرنبار	xarambAr	xaranbAr
عجایز	'ajAyez	'ajAyez
زهازه	zehAze	zahAze
دربین	darbeyne	darbin
دشواررو	doSvArro	doSvArro
نموشک	namuSak	namuSak
خزید	xazid	xazid
مرقشیشا	marqaSiSA	marqaSiSA
بناحق‌ریخته‌شده	benAhaqrixteSode	banAhaqrixteSode
دموگرافی	demogerAfi	demogerAfi
مشروع	maSru'	maSru'
زمردنشان	zomorrodneSAn	zamradneSAn
هولوگرام	hologerAm	hologerAm
اشباه	'aSbAh	'aSbAh
تحبیب	tahbib	tahbib
لاتحصی	lAtohsA	lAtahsi
آب‌تنباکو	'AbtanbAku	'AbtanbAku
آب‌سنگ	'Absang	'Absang
باب	bAb	bAb
آژ	'AZ	'AZ
بیاضی	bayAzi	bayAzi
خارکنی	xArkani	xArkani
دروبطارس	darubetAres	darrobatAres
نجیب‌زاده	najibzAde	najibzAde
بی‌واهمه	bivAheme	bivAheme
هلم‌جرا	halommajarrA	helmjerA
غراره	qerAre	qarAre
رنگ‌کننده	rangkonande	rangkonande
دیفتری	difteri	diftari
فلخودن	falxudan	falxudan
اخوین	'axaveyn	'axvin
هلسپونت	helespont	helespont
حیوانی	heyvAni	heyvAni
پیونددار	peyvanddAr	peyvandAr
باتر	bAter	bAter
مفعول	maf'ul	maf'ul
آداب‌دانی	'AdAbdAni	'AdAbdAni
سیران	seyrAn	sirAn
پتر	petr	peter
مصطنع	mostane'	mastane'
جعل	jo'al	ja'l
فرع	far'	far'
پس‌افتاده	pas'oftAde	pas'oftAde
نیمه‌اغماء	nime'eqmA'	nime'eqmA'
علامت‌دهنده	'alAmatdahande	'alAmatdahande
آرژانتینی	'ArZAntini	'ArZAntini
زریری	zariri	zariri
آوری	'Avari	'Avari
جنگلداری	jangaldAri	jangaldAri
لنجان	lenjAn	lanjAn
پهلودستی	pahludasti	pahludasti
آکومولاتور	'AkomulAtor	'AkomolAtor
انفجاری	'enfejAri	'enfejAri
میلی‌لیتر	mililitr	milileyter
صفین	seffeyn	safin
استروما	'estromA	'esteromA
آنوریسم	'Anurism	'Anorism
معنابخش	ma'nAbaxS	ma'nAbaxS
میله	mile	mile
زنبلغ	zambaloq	zanbalaq
نجاریان	najjAriyAn	najjAriyAn
خوشایندی	xoSAyandi	xoSAyandi
تبارز	tabAroz	tabAroz
زیان	ziyAn	ziyAn
پژوهندگی	paZuhandegi	paZuhandegi
فیلفوس	filofos	filfus
کلات	kalAt	kalAt
صلح‌طلب	solhtalab	solhtalab
گاوصندوق	gAvsandoq	gAvasanduq
رنگ‌زردی	rangzardi	rangzardi
دبیر	dabir	dabir
انشعابی	'enSe'Abi	'enSe'Abi
شهلاپور	SahlApur	SahlApur
سبک‌سنگین	saboksangin	sabksangin
پوست‌آکنی	pust'Akani	pust'Akani
زرینه‌فام	zarrinefAm	zarrinefAm
مهرجویی	mehrjuyi	mehrjuyi
دکلان	doklAn	deklAn
تخریب‌کننده	taxribkonande	taxribkonande
فرکانس	ferekAns	farkAns
دماکره	damAkore	damAkere
کسیلوفن	kesilofon	kasilofen
القصه	'alqesse	'alqase
طغیانگری	toqyAngari	toqyAngari
شوهر	Sohar	Sohar
پرماسیده	parmAside	parmAside
بشک	boSk	baSk
استه	'esteh	'aste
صادقی‌زاده	sAdeqizAde	sAdeqizAde
مرجب	morajjab	marjab
خوش‌آمد	xoS'Amad	xoS'Amad
بی‌خس	bixas	bixas
کیهان‌خدیو	keyhAnxadiv	kihAnxadiv
غلبکین	qalbakin	qalbakin
کفائی	kafA'i	kafA'i
برژنف	bereZnef	barZanaf
غوک‌جامه	qukjAme	qukjAme
بهیج	bahij	bahij
شصت‌کیلومتری	Sastkilumetri	Sastkilumetri
بی‌معرفت	bima'refat	bima'refat
پان‌ایرانیست	pAn'irAnist	pAn'irAnist
فاژیدن	fAZidan	fAZidan
هان	hAn	hAn
سرطان‌زایی	saratAnzAyi	sartAnzAyi
پژوهشی	paZuheSi	paZuheSi
کارسنج	kArsanj	kArsanj
آب‌نبات‌چوبی	'AbnabAtCubi	'AbnabAtCubi
اهداف	'ahdAf	'ehdAf
عصات	'osAt	'asAt
ملک‌آرا	molk'ArA	malek'ArA
پرانه	parAne	parAne
مهرپناه	mehrpanAh	mehrpanAh
پریر	parir	parir
احرازشده	'ehrAzSode	'ehrAzSode
لوسانه	lusAne	lavasAne
شاباتی	SAbAti	SAbAti
طفل	tefl	tafl
شاه	SAh	SAh
اطاقسازی	'otAqsAzi	'otAqsAzi
بی‌درمان	bidarmAn	bidarmAn
ورتیج	vartij	vartij
ادراک‌کننده	'edrAkkonande	'edrAkkonande
گچ‌کاری	gaCkAri	gaCkAri
شیر	Sayyer	Sir
یوم‌النحر	yomonnahr	yomonnahr
شاشدان	SASdAn	SASdAn
پنج‌ستاره	panjsetAre	panjesetAre
چهره‌نما	CehrenamA	CehrenamA
بی‌بندوبار	bibandobAr	bibandobAr
بسمله	besmele	basmale
تاثم	ta'assom	ta'assom
توطن	tavatton	tutan
طاس‌باز	tAsbAz	tAsbAz
بارومتر	bArometr	bArometr
هنرسرا	honarsarA	honarsarA
نامتحرک	nAmoteharrek	nAmoteharek
دنباله‌دار	donbAledAr	donbAledAr
تطلب	tatallob	tatallob
پرآرایش	por'ArAyeS	por'ArAyeS
شریعت‌نژاد	Sari'atneZAd	Sari'atneZAd
تسلیحات	taslihAt	taslihAt
جوانی	jevAni	javAni
سیاهکاری	siyAhkAri	siyAhkAri
مغناطیسی	meqnAtisi	maqnAtisi
کها	kahA	kahA
استراسبرگ	'esterAsborg	'esterAsbarg
مخزون	maxzun	maxzun
کحل	kohl	kahal
سپردنی	sepordani	sepordani
جبلهنگ	jablahang	jablahang
تعذیه	ta'ziye	ta'ziye
چهل‌دقیقه‌ای	Ceheldaqiqe'i	Ceheldaqiqe'i
برون‌مرزی	borunmarzi	borunmarzi
کالیده	kAlide	kAlide
تهویل	tahvil	tahvil
طریان	tarayyAn	taryAn
غیرخردمندانه	qeyrexeradmAndAne	qeyrexeradmandAne
واجی	vAji	vAji
ثوب	sob	sub
نفوذ	nofuz	nofuz
جنسی	jensi	jensi
تردماغ	tardamAq	tardmAq
غارتگری	qAratgari	qAratgari
ارجا	'erjA	'arjA
زمهریر	zamharir	zemehrir
اکتسابی	'ektesAbi	'ektesAbi
غیرقابل‌اعتماد	qeyreqAbele'e'temAd	qeyreqAbele'a'temAd
پارالل	pArAlel	pAroll
کامجوئی	kAmju'i	kAmju'i
عرعر	'ar'ar	'ar'ar
بشنج	beSanj	baSanj
وحیدیه	vahidiyye	vahidiyye
یونید	yunid	yonid
گریخت	gorixt	gorixt
وطات	vat'at	vatAt
کوردلی	kurdeli	kurdeli
زربفت	zarbaft	zarbaft
علمدار	'alamdAr	'elmdAr
عالم	'Alam	'Alem
واکنشی	vAkoneSi	vAkoneSi
آرترولوژی	'ArteroloZi	'ArteroloZi
کردتبار	kordtabAr	kerdetabAr
دوبلین	dublin	dobalin
نان‌وپنیر	nAnopanir	nAnopanir
ملوک‌الطوایف	molukottavAyef	molukottavAyef
پین	pin	pin
وافوری	vAfuri	vAfuri
نگریسته	negariste	negriste
سرقت‌شده	serqatSode	serqatSode
غیرانقلابی	qeyre'enqelAbi	qeyre'enqelAbi
برنامه	barnAme	barnAme
یالانچی	yAlAnCi	yAlAnCi
گوش‌بین	guSbin	guSbin
اکوادور	'ekvAdor	'ekvAdor
سکن	sakan	sekan
غرنب	qoromb	qoromb
اسب	'asb	'asab
بتن‌ریز	betonriz	botonriz
نیک‌محضر	nikmahzar	nikmahzar
هکذا	hAkazA	hekzA
کهبد	kohbod	kahbad
تکسر	takassor	takassor
فخار	fexAr	faxxAr
ماژیک	mAZik	mAZik
دگر	degar	degar
عیسی‌زاده	'isAzAde	'isizAde
محمدبن‌جریر	mohammadebnejarir	mohammadenjarir
گنبدخانه	gombadxAne	gonbadxAne
خارش	xAreS	xAreS
گمانه‌زنی	gomAnezani	gomAnezani
آب‌انبار	'AbanbAr	'AbenbAr
بدعهد	bad'ahd	bad'ahd
شرائط	SarA'et	SarA'et
پرستوسادات	parastusAdAt	parastosAdAt
تجهم	tajahhom	tajahhom
راه‌انجام	rAh'anjAm	rAhenjAm
اکسیده	'okside	'okside
هیچ‌کس	hiCkas	hiCkas
ملبوس	malbus	malbus
سردوشی	sarduSi	sarduSi
ثاقب	sAqeb	sAqeb
بلغد	bolqad	bolqad
عمه‌زاده	'ammezAde	'ammezAde
پالیدن	pAlidan	pAlidan
توسم	tavassom	tavassom
رحلی	rahli	rahalli
آرتیکل	'Artikel	'Artikel
نشاط	neSAt	neSAt
سال	sAl	sAl
تارک	tArek	tArak
صبه	sobbe	sabbe
بهرمانی	bahramAni	bahramAni
بلک	balak	balak
متافیزیک	metAfizik	mota'fizik
فسفرتابی	fosfortAbi	fosfortAbi
افراط‌گرائی	'efrAtgerA'i	'efrAtgerA'i
عقبایی	'oqbAyi	'aqbAyi
مبلغ	mablaq	moballaq
ژله	Zele	Zele
داوودی	dAvudi	dAvudi
ورق‌پاره	varaqpAre	varaqpAre
سنبله	sombole	sombole
مودع	mude'	movadda'
مقفل	moqaffal	maqfal
تپنکوز	tapankuz	tapankuz
بادران	bAdrAn	bAdrAn
پلیور	poliver	poliver
نای‌انبان	nAy'ambAn	nAye'anbAn
عرقی	'araqi	'araqqi
ریاضت‌پیشه	riyAzatpiSe	riyAzatpiSe
درنوشتن	darneveStan	darneveStan
رهابنه	rahAbene	rahAbene
پاوند	pAvand	pAvand
لشکرشکن	laSkarSekan	laSkarSekan
خون‌دماغ	xundamAq	xundamAq
درده	dorde	darde
سودجویانه	sudjuyAne	sudjuyAne
طلیق	taliq	taliq
هارولد	hArold	hArvald
یون	yun	yon
نامتوازن	nAmotevAzen	nAmatvAzen
دستارچه	dastArCe	dastArCe
پرتحول	portahavvol	portahavvol
ذاهل	zAhel	zAhel
آوردگاه	'AvardgAh	'AvardgAh
اسدیاری	'asadyAri	'asadyAri
بازگو	bAzgu	bAzgu
تریشینوز	teriSinoz	teriSinoz
آکو	'Aku	'Ako
ره‌آورد	rah'Avard	rah'Avard
تبایع	tabAyo'	tabAyo'
بیفائده	bifA'ede	bifA'ede
علف‌چر	'alafCar	'alafCar
بازسان	bAzsAn	bAzsAn
ونژد	vanZad	vanZad
ارزان‌فروشی	'arzAnforuSi	'arzAnforuSi
المنت	'element	'almant
فلرزنگ	falarzang	felerzang
انگورپزان	'angurpazAn	'angurpazAn
نارنجکی	nArenjaki	nAranjaki
آبست	'Abast	'Abest
حدقات	hadaqAt	hadaqAt
فلسفید	falsafid	falsefid
اذیال‌الناس	'ezyAlonnAs	'azyAlonnAs
قائمیان	qA'emiyAn	qA'emiyAn
فروشگاه	foruSgAh	foruSgAh
نسک	nask	nask
بوبه	bube	bube
چرخ‌دنده	Carxdande	Carxdande
خزائی	xozA'i	xazA'i
شجاع‌الدین	SojA'eddin	SojA'oddin
اولویت‌دهی	'olaviyyatdehi	'olaviyyatdehi
یک‌ماده‌ای	yekmAdde'i	yekmAde'i
مایه	mAye	mAye
میله‌دار	miledAr	miledAr
روغ	ruq	ruq
تخسیر	taxsir	taxsir
ضرب‌خوردگی	zarbxordegi	zarbxordegi
بی‌اندازه	bi'andAze	bi'andAze
جوزجان	jozjAn	jozjAn
دزفول	dezful	dezful
فرناندز	fernAndez	farnAndez
هشت‌ومشت	haStomoSt	haStomaSt
روسی‌الاصل	rusiyol'asl	rusiyol'asl
اژدهاک	eZdehAk	'aZdahAk
کماسه	kamAse	kamAse
آدم‌کشی	'AdamkoSi	'AdamkeSi
زندگی‌سوز	zendegisuz	zendegisuz
فارغ‌التحصیلی	fAreqottahsili	fAreqottahsili
فراموش‌شده	farAmuSSode	farAmuSSode
تکنیسین	teknisiyan	teknisin
میادین	mayAdin	miyAdin
لاکتیک‌اسید	lAktikasid	lAktikasid
پرنیخ	parnix	pornix
سیسرک	sisarak	siserk
واریزنامه‌ای	vAriznAme'i	vAriznAme'i
ساخته	sAxte	sAxte
تنباکو	tambAku	tanbAko
اسپرفیت	'esporofit	'esperfit
اسفنکتر	'esfankter	'esfankter
طویل‌القامه	tavilolqAme	tavilolqAme
ستین	settin	setin
نسخ	nosax	nasx
صلوات‌الله‌علیهم	salavAtollAho'alayhem	salavAtollAhe'alayhem
شوی‌دیده	Suydide	Savidide
پارس	pArs	pArs
جان‌گزا	jAngazA	jAngazA
خالواش	xAlvAS	xAlvAS
مهاجرانی	mohAjerAni	mahAjerAni
لطایف	latAyef	latAyef
پوی	puy	puy
کوبیدگی	kubidegi	kubidegi
حشر	haSr	haSar
صینی	sini	sini
سرطاس	sartAs	sartAs
موزی	mozi	muzi
چهارجانبه	CAhArjAnebe	CAhArjAnebe
غیرارشادی	qeyre'erSAdi	qeyre'erSAdi
اوزون	'ozon	'ozon
عبدالرحمن‌بن‌خالدبن‌ولید	'abdorrahmAnebnexAledebnevalid	'abdorrahmnenebne
غبارگیر	qobArgir	qobArgir
اسکانیا	'eskAniyA	'eskAniyA
شتربچه	SotorbaCCe	SotorbCe
گلدسمیت	goldesmit	goldesammiyyat
دروانه	darvAne	darvAne
قربان	qorbAn	qarbAn
ایستانیدن	'istAnidan	'istAnidan
اشناختن	'eSnAxtan	'eSnAxtan
جزیی‌نگر	jozyinegar	jazinegar
لابه	lAbe	lAbe
ابن‌سعد	'ebnesa'd	'ebnesa'd
تصاویر	tasAvir	tasAvir
پشت‌دار	poStdAr	poStdAr
بتکوب	batkub	botkub
شخسار	SaxsAr	SaxsAr
عباس‌میرزا	'abbAsmirzA	'abAsmirzA
برزوبالا	borzobAlA	barzobAlA
مذنب	mozanneb	maznab
پیش‌آهنگی	piS'Ahangi	piS'Ahangi
پالانی	pAlAni	pAlAni
هنگامی	hengAmi	hengAmi
خسارت‌بار	xesAratbAr	xesAratbAr
آدم‌برفی	'Adambarfi	'Adambarfi
مهرشهر	mehrSahr	mehrSahr
بوته‌ای	bute'i	bute'i
گرچه	garCe	garCe
فراآوردن	farA'Avardan	farA'Avardan
مسرور	masrur	masrur
ایران‌دوچرخ	'irAndoCarx	'irAndoCarx
خارا	xArA	xArA
فرارسید	farAresid	farArsid
تغار	taqAr	taqAr
پاره‌پاره	pArepAre	pArepAre
توفیق	tofiq	tofiq
شاددل	SAddel	SAddel
خوش‌ذقن	xoSzaqan	xoSzaqan
حسابرسی	hesAbresi	hesAbresi
زرو	zaru	zarv
پسریچه	pesariCe	pesariCe
حتمی	hatmi	hatmi
محاریب	mahArib	mohArib
اتفاقی	'ettefAqi	'ettefAqi
نیمه‌فعال	nimefa''Al	nimefa'Al
هم‌مباحثه	hammobAhese	hammabAhese
وارف	vAref	vAref
معرض	mo'rez	ma'raz
نغمه‌سرا	naqmesorA	naqmesarA
ملل	melal	malal
مطبقه	motbeqe	motabbaqe
سازکرده	sAzkarde	sAzkarde
کافه‌نشین	kAfeneSin	kAfeneSin
صنوبر	senobar	sonubar
ابوحسن	'abuhasan	'abuhasan
خواندن	xAndan	xAndan
قابل‌تفکیک	qAbeletafkik	qAbeletafkik
گراهام	gerAhAm	gerAhAm
علف‌زار	'alafzAr	'alafzAr
سرگرانی	sargerAni	sargerAni
دول	dul	doval
لهنج	lahanj	lahanj
فوات	favAt	favAt
فوق‌کلیه	foqekolye	foqekeliyye
نوع‌دوستانه	no'dustAne	no'dustAne
روح	ruh	ruh
واگذارکننده	vAgozArkonande	vAgozArkonande
سیم‌کش	simkeS	simkeS
وجه‌الضمان	vajhozzemAn	vajhozzamAn
دست‌دوزی	dastduzi	dastduzi
کامل‌نشده	kAmelnaSode	kAmelnaSode
نصرالدین	nasreddin	nasredin
ریشه	riSe	riSe
ربع‌قرن	rob'qarn	rob'eqaran
تحدیدکننده	tahdidkonande	tahdidkonande
بی‌مخی	bimoxi	bimaxy
وحشتناک	vahSatnAk	vahSatnAk
پورپورا	purpurA	purpurA
ابتداع	'ebtedA'	'ebtedA'
جلادت	jalAdat	jalAdat
آوردن	'Avardan	'Avardan
اسرافیلی	'esrAfili	'esrAfili
آرامگاهی	'ArAmgAhi	'ArAmgAhi
پنج‌گوشه	panjguSe	panjguSe
سینه‌به‌سینه	sinebesine	sinebesine
پنج‌دقیقه‌ای	panjdaqiqe'i	panjdaqiqe'i
ازهد	'azhad	'azhad
زاهدان	zAhedAn	zAhedAn
تاج‌خروس	tAjxorus	tAjxerus
دودخانه	dudxAne	dodxAne
شماره‌گیری	SomAregiri	SomAregiri
ایل‌بیگی	'ilbeygi	'ilbeygi
منتن	monten	montan
مشتق	moStaqq	moStaq
انتساق	'entesAq	'entesAq
لزوم	lozum	lozum
واگون	vAgun	vAgon
یادبود	yAdbud	yAdbud
پارابلوم	pArAblom	pArAblom
مستکره	mostakrah	mostakre
ارک	'ark	'arak
درونروی	darunruy	darunervi
نخجل	naxjal	naxjal
سازش‌کارانه	sAzeSkArAne	sAzeSkArAne
کماسه‌گری	kamAsegari	kamAsegari
آتیلا	'AtilA	'AtilA
اشو	'aSu	'aSv
پولادی	pulAdi	pulAdi
دباغ‌پور	dabbAqpur	debAqpur
گرداننده	gardAnande	gardAnande
تلسک	telesk	talassok
ترب‌سیاه	torobsiyAh	tarbsiyAh
اشکردن	'eSkardan	'eSkardan
کمر	kamar	kamr
بیژن	biZan	biZan
آناکوندا	'AnAkondA	'AnAkondA
طرفین	tarafeyn	tarfin
قالیچه	qAliCe	qAliCe
ردف	redf	radf
خمار	xomAr	xammAr
دهنه	dahane	dahne
زنبوران	zanburAn	zanburAn
آیدا	'AydA	'AydA
پرماه	pormAh	pormAh
شبه‌پول	Sebhepul	Sebhpul
دوستی	dusti	dosati
پری‌آباد	pari'AbAd	pari'AbAd
آنکش	'AnkeS	'AnkeS
تجویزکننده	tajvizkonande	tajvizkonande
باریک‌میان	bArikmiyAn	bArikmiyAn
سردم	sardam	sardam
تباهه	tabAhe	tabAhe
بالتیک	bAltik	bAltik
پرهیخته	parhixte	parhixte
متوفی	motevaffA	motevaffi
جورابچیان	jurAbCiyAn	jurAbaCiyAn
رجالی	rejAli	rajjAli
خیانت	xiyAnat	xiyAnat
رئوفانه	ra'ufAne	ra'ufAne
ابرجنایتکار	'abarjenAyatkAr	'abarjenAyatkAr
گیلز	gilz	gilz
پرخاش‌کیش	parxASkiS	parxASkiS
صوابدید	savAbdid	savAbed
سینه‌راما	sinerAmA	sinerAmA
سوئز	su'ez	su'ez
فاکتور	fAktor	fAktor
هجی	hejji	haji
غریبانه	qaribAne	qaribAne
کوچ‌نشینی	kuCneSini	kuCneSini
ریختنی	rixtani	rixtani
اشتاب	'eStAb	'eStAb
موردنظر	moredenazar	moredenazar
گسستن	gosastan	gosestan
جنفج	janfaj	janfaj
هزارجریب	hezArjarib	hezArjarib
شکرخا	SekarxA	SekarxA
آخروعاقبت	'Axaro'Aqebat	'Axro'Aqebat
تازه‌اکران‌شده	tAze'ekrAnSode	tAze'okrAnSode
دیپلوکوک	diplokok	diplokok
ریمل	rimel	rimel
بسا	basA	basA
عود	'od	'ud
سانحه‌دیده	sAnehedide	sAnehedide
خزل	xazl	xazal
برو	boro	barv
خرمن‌سوخته	xarmansuxte	xarmansuxte
بزور	bozur	bozur
کاساب	kAsAb	kAsAb
آبتنی	'Abtani	'Abtani
استقلال‌رسیده	'esteqlAlreside	'esteqlAlreside
بلشویکی	bolSeviki	bolSaviki
رو	rav	ro
آوردخواه	'AvardxAh	'AvardxAh
گنبد	gonbad	gonbad
مجتری	mojtari	mojtari
پرلود	perlud	porlud
مبالغ	mabAleq	mobAleq
بلعکس	bel'aks	bal'aks
شایان	SAyAn	SAyAn
پشتکار	poStekAr	poStkAr
خوش‌منظره	xoSmanzare	xoSmanzare
علامتی	'alAmati	'alAmati
غیراروپائی	qeyre'orupA'i	qeyre'orupA'i
آزمون‌شناسی	'AzmunSenAsi	'AzmunSenAsi
پرفسوس	porfosus	porfos
قلبی‌شکل	qalbiSekl	qalbiSekl
حسبه	hesbe	hasbe
رویان	ruyAn	royAn
پایان‌پذیر	pAyAnpazir	pAyAnpazir
پسماند	pasmAnd	pesmAnd
بی‌آب	bi'Ab	bi'Ab
کویل	koyl	kavil
شش‌هفت‌ماهه	SeShaftmAhe	SeShaftmAhe
قلیا	qalyA	qaliyA
جذاذه	jozAze	jazze
دیومردم	divmardom	diyomardom
بهتاش	behtAS	bohtAS
پرزین	porzin	parzin
پشت‌گلی	poStgoli	poStgeli
ثنائی	sanA'i	sanA'i
تمثل	tamassol	tamassol
آگوتی	'Agoti	'Aguti
نیل‌گر	nilgar	nilgar
منایح	manAyeh	manAyeh
سرپایی	sarpAyi	sarpAyi
عشق	'eSq	'eSq
خرده‌گیری	xordegiri	xordegiri
گاومیش	gAvmiS	gAvmiS
برپاسازی	barpAsazi	barpAsAzi
جنح	jenh	janh
ابن	'ebn	'abn
بولشویسم	bolSevism	bulSevism
تپش	tapeS	tapeS
گامتوفیت	gAmetofit	gAmtofit
متواطی	motavAti	motevAti
پیش‌سلام	piSsalAm	piSsalAm
واهنربا	vAhanrobA	vAhonarbA
مخاطر	maxAter	maxAter
سوگمندانه	sugmandAne	sugmandAne
پنیرسازی	panirsAzi	panirsAzi
بکرزایی	bekrzAyi	bekrazAyi
تشارین	taSArin	taSArin
تلاعب	talA'ob	talA'ob
تواره	tovAre	tavAre
پیاده	piyAde	piyAde
پلور	polur	polor
کلریدریک	koloridrik	koloridrik
بالاتیره	bAlAtire	bAlAtire
اسکیزه	'eskize	'eskize
شش‌سالگی	SeSsAlegi	SeSsAlegi
میلی‌مترمربع	milimetremorabba'	milimetremorabba'
عثمانی	'osmAni	'osmAni
پوچال	puCAl	puCAl
ددر	dadar	dadr
غلات	qallAt	qalAt
قارچ‌ها	qArChA	qArChA
باغی	bAqi	bAqi
زرباف	zarbAf	zarbAf
سلحشوری	salahSuri	salahSuri
برگیر	bargir	bargir
یک‌ترمی	yektermi	yektarmi
منوساکارید	monosAkArid	manusAkArid
ولو	valo	valu
پالایش	pAlAyeS	pAlAyeS
تجمیع	tajmi'	tajmi'
خیرالله‌زاده	xeyrollAhzAde	xirollAhzAde
سوخت	suxt	suxt
مسئولانه	mas'ulAne	mas'ulAne
مروح	moravveh	moravvah
خوابنیدن	xAbanidan	xAbonaydan
پرمحتوا	pormohtavA	pormohtavA
گشت	geSt	gaSt
مرداویج‌بن‌زیار	mardAvijebneziyAr	mardAvijebnezayAr
روبنایی	rubanAyi	rubanAyi
لنگ‌وپاچه	lengopACe	langopACe
دیکتاتورانه	diktAtorAne	diktAtorAne
آستروگرافی	'AstrogerAfi	'AsterogerAfi
مستاجر	mosta'jer	mostAjer
سبیلی	sabili	sabili
درنیامده	darnayAmade	darnayAmade
کمین‌گذاری	kamingozAri	kamingozAri
کارگرنشین	kArgarneSin	kArgarneSin
ضلالت	zelAlat	zelAlat
خرمنج	xarmonj	xarmanj
رپورتاژ	reportAZ	reportAZ
کازیه	kAziye	kAziye
غریب‌القرآن	qaribolqor'An	qaribolqor'An
بزمی	bazmi	bazmi
جوشک	juSak	juSak
درهم‌پیچیده	darhampiCide	darhampiCide
اندخسواره	'andaxsvAre	'andaxsavAre
جسماً	jesman	jasman
تقعیر	taq'ir	taq'ir
امامت	'emAmat	'emAmat
هندوکش	hendokeS	hendokeS
پلی‌وینیل‌کلراید	polivinilkolorAyd	palivinilkolkolkAyd
مورچه‌گیر	murCegir	murCegir
زمانه‌ساز	zamAnesAz	zamAnesAz
غارتزده	qAratzade	qArtzade
مشترکاً	moStarekan	moStarakan
مدساز	modsAz	madsAz
اهرمن‌لاخ	'ahremanlAx	'ahramanlAx
زاروزندگی	zArozendegi	zAruzandegi
بخشودگی	baxSudegi	baxSudegi
سبی	saby	sabi
هیچگرا	hiCgerA	hiCgerA
نایب‌رئیسی	nAyebra'isi	nAyebra'isi
نصایح	nasAyeh	nasAyeh
ضدکشوری	zeddekeSvari	zeddekeSvari
غیرسرمایه‌داری	qeyresarmAyedAri	qeyresarmAyedAri
آئینه‌خانه	'A'inexAne	'A'inexAne
به‌رایگان	berAyegAn	berAyegAn
وز	vaz	vez
ارزشگرا	'arzeSgerA	'arzeSgerA
نص	nass	nass
ئیدروفیل	'idrofil	'idrofil
همدست	hamdast	hamdast
هوفاریقون	hufAriqun	hufAriqun
دیلی‌نیوز	deyliniyuz	diliniyuz
گوپاره	gopAre	gupAre
فسرانیدن	fesorAnidan	fosrAnidan
احمدشاه	'ahmadSAh	'ahmadSAh
خواربارفروشی	xArobArforuSi	xArbArforuSi
امدادیان	'emdAdiyAn	'emdAdiyAn
فویلی	foyli	favili
نقره‌سازی	noqresAzi	noqresAzi
عزت‌نژاد	'ezzatneZAd	'ezzatneZAd
حفاظتی	hefAzati	hefAzati
آزردن	'Azordan	'Azordan
مرسی	mersi	marsi
وی	vey	vi
قچ	qoC	qaC
غیرهم	qeyrohom	qeyreham
گزای	gazAy	gazAy
قمارباز	qomArbAz	qamArbAz
راست‌رو	rAstro	rAstro
شگفت‌زدگی	Segeftzadegi	Segeftzadegi
کمانگیر	kamAngir	kamAngir
دگردیسی	degardisi	degardisi
هوبه	hube	hovabe
مبذول	mabzul	mabzul
مترف	motraf	motaraf
ساقه‌بلند	sAqeboland	sAqeboland
است	'ast	'est
کامل‌عیار	kAmel'ayAr	kAmele'ayAr
بلالی	balAli	balAli
ناخدایی	nAxodAyi	nAxodAyi
لنفی	lanfi	lanfi
غیرمستعمره	qeyremosta'mere	qeyremosta'mere
اطایب	'atayeb	'atAyeb
ظهیرالدوله	zahiroddole	zahiroddole
بداوت	badAvat	badAvat
اوعیه	'o'iye	'o'iyye
دیگ	dig	dig
نیاورده	nayAvarde	nayAvarde
به‌همین‌منظور	behaminmanzur	behaminmanzur
خیال‌باف	xiyAlbAf	xiyAlbAf
نیل‌فام	nilfAm	nilfAm
نقدینه	naqdine	naqdine
پرسرعت	porsor'at	porsor'at
سینه‌زن	sinezan	sinezan
غیاب	qiyAb	qayyAb
خرام	xarAm	xarAm
روبیان	rubiyAn	rubiyAn
تبلیغ‌شده	tabliqSode	tabliqSode
بیرجندی	birjandi	birjandi
لیزین	lizin	lizin
آنگلوفوب	'Angelofob	'Angelofob
سپهران‌سپهر	sepehrAnsepehr	sepehrAnsepehr
نایپوش	nAypuS	nAypuS
فردگرائی	fardgerA'i	fardgerA'i
شماتتگر	SemAtatgar	SemAtatgar
سوچی	suCi	suCi
برگماردن	bargomArdan	bargmArdan
ریزنقش	riznaqS	rizanaqS
اوکی	'okey	'oki
کولاک	kulak	kulAk
غازان	qAzAn	qAzAn
آکریلیک	'Akrilik	'Akrilik
متعبد	mota'abbed	mote'abbed
هومر	humer	homer
بدریخت	badrixt	badrixt
سبحانی	sobhAni	sobhAni
کامفر	kAmfer	kAmfer
پی‌شناسی	peySenAsi	peySenAsi
طلقی	talqi	talaqqi
جمله‌ای	jomle'i	jomle'i
سندر	sandar	sandar
سهل‌القبول	sahlolqabul	sahlolqabul
سروگاه	sorugAh	sarogAh
فنائیان	fanA'iyAn	fanA'iyAn
جویده	javide	javide
عقده‌گشا	'oqdegoSA	'oqdegoSA
آرام‌آرام	'ArAmArAm	'ArAm'ArAm
تکین	takin	takayyon
دفائن	dafA'en	dafA'en
پرچمدار	parCamdAr	parCamdAr
یافت‌شده	yAftSode	yAfatSode
زبده	zobde	zabade
خاک‌اره	xAk'arre	xAkere
کفش‌کن	kafSkan	kafSkan
محبت	mohabbat	mohabbat
بندباز	bandbAz	bandbAz
نورآدرنالین	nur'AdrenAlin	nur'AdernAlin
کپور	kapur	kapur
جاده‌سازی	jAddesAzi	jAddesAzi
کاراکتر	kArAkter	kArAkter
بی‌همتا	bihamtA	bihamtA
زیربنا	zirbanA	zirbanA
پدیده	padide	padide
غیه	qiyye	qiye
قراختائی	qarAxatA'i	qarAxtA'i
پوشانیده	puSAnide	puSAnide
دست‌کاری‌شده	dastkAriSode	dastkAriSode
سردابه	sardAbe	sardAbe
آوا	'AvA	'AvA
انعطافی	'en'etAfi	'en'etAfi
لنینیسم	leninism	leninism
الاغ	'olAq	'alAq
قدم	qedam	qadam
لادین	lAdin	lAdin
مدحت	medhat	madhat
لجن	lajan	lajan
آبدره	'Abdarre	'Abdare
رقم	raqam	raqam
ورزیدن	varzidan	varzidan
مهاب	mahAb	mahAb
داعی‌الدعاة	dA'iyoddo'At	dA'eyoddo'Ate'At
کبربا	kabarbA	kabrbA
ازاراقی	'azArAqi	'ezArAqi
تستر	toster	tasattor
پرتکلف	portakallof	portakallof
پخزنی	paxzani	paxzani
خفقان‌آور	xafaqAn'Avar	xafaqAn'Avar
فائح	fA'eh	fA'eh
دولتداری	dolatdAri	doltedAri
نزار	nazAr	nazAr
پاگودا	pAgodA	pAgodA
اصل	'asl	'asl
زیرخط	zirxatt	zirxat
سجال	sejAl	sajjAl
مهرتاش	mehrtAS	mehratAS
کستر	kastar	kastar
پارین	pArin	pArin
تال‌ومال	tAlomAl	tAlomAl
بی‌آلایشی	bi'AlAyeSi	bi'AlAyeSi
خیسانده	xisAnde	xisAnde
یاجوج	ya'juj	yAjuj
لوله‌سانان	lulesAnAn	lulesAnAn
متنبه	motenabbeh	motanabbeh
چرا	CerA	CerA
خربندگی	xarbandegi	xarbandegi
خاتمیت	xAtamiyyat	xAtamiyyat
انسان‌ساز	'ensAnsAz	'ensAnsAz
انتفاعی	'entefA'i	'entefA'i
گستاخی	gostAxi	gostAxi
اشکبوس	'aSkbus	'aSkbus
ژاژخواهی	ZAZxAhi	ZAZxAhi
باغبان	bAqbAn	bAqbAn
طواف‌گاه	tavAfgAh	tavAfgAh
فکاهت	fokAhat	fekAhat
آب‌سوار	'AbsavAr	'AbsavAr
ستیخ	setix	setix
کرز	korz	karz
مجمع	majma'	majma'
گالش	gAleS	gAleS
عمدی	'amdi	'amadi
شیربخ	Sirbax	Sirbax
سنجه	sanje	sanje
مسهد	mosahhad	mashad
هادیان	hAdiyAn	hAdyAn
خروس‌بازی	xorusbAzi	xorusbAzi
پرانید	parAnid	parAnid
ازدست	'azdaste	'azdast
نمیر	namir	namir
مشروح	maSruh	maSruh
تورم	tavarrom	tavarrom
چندشکلی	CandSekli	CandSekli
تحفه	tohfe	tahaffe
جمیلی	jamili	jamili
مخاطب‌شناسی	moxAtabSenAsi	moxAtebSenAsi
باشرافت	bASerAfat	bASrAft
سیادت	siyAdat	siyAdat
قناسی	qenAsi	qanAsi
آلگ	'Alag	'Alg
چندپاره	CandpAre	CandpAre
کاظمی	kAzemi	kAzemi
ممارست	momAresat	momAresat
کم‌فشار	kamfeSAr	kamfeSAr
سفالینه	sofAline	safAline
مجاز	majAz	majAz
مصیبت‌بار	mosibatbAr	mosibatbAr
مزدبگیری	mozdbegiri	mozdabgiri
زیرآب	zir'Ab	zir'Ab
استعدادی	'este'dAdi	'este'dAdi
آب‌پرده	'Abparde	'Abparde
شالیکاری	SAlikAri	SAlikAri
غدر	qadr	qadr
چیزک	Cizak	Cizak
تذکره‌نویس	tazkarenevis	tazkarenevis
نزیه	nazih	naziyye
باکتریایی	bAkteriyAyi	bAkteriyAyi
شبینه	Sabine	Sabine
طرد	tard	tard
آسمانکان	'AsemAnkAn	'AsmAnkAn
نامنظم	nAmonazzam	nAmanzam
هیأت‌منصفه	hey'atmonsefe	hey'atmansafe
قاسطین	qAsetin	qAsetin
خودگزین	xodgozin	xodgozin
محضالله	mahzanlellAh	mahzAllAh
سنگاب	sangAb	sangAb
پاپیچال	pApiCAl	pApiCAl
کمربندی	kamarbandi	kamarbandi
مصطفایی	mostafAyi	mostafAyi
کله	kele	kalle
مهچه	mahCe	mahCe
نازک‌شده	nAzokSode	nAzokSode
غفول	qoful	qaful
دیونژاد	divneZAd	diyoneZAd
ارجان	'arjAn	'arjAn
تاریخچه	tArixCe	tArixCe
ناخوشبختی	nAxoSbaxti	nAxoSbaxti
ختنبر	xatambar	xatanbar
دیگ‌بردیگ	digbardig	digbardig
اشتغال‌زایی	'eSteqAlzAyi	'eSteqAlzAyi
گرمایش	garmAyeS	garmAyeS
دق‌الحصیر	daqqolhasir	daqqolhasir
نیتراسیون	nitrAsiyon	nitrAsiyon
شمیران	SemirAn	SamirAn
کوزه‌شکسته	kuzeSekaste	kuzeSekaste
قتاد	qatAd	qattAd
انزجارآمیز	enzejAr'Amiz	enzejAr'Amiz
پدافند	padAfand	pedAfand
قشر	qeSr	qaSr
نوین‌سازی	novinsAzi	novinsAzi
فرهنگنامه	farhangnAme	farhangnAme
توارثی	tavArosi	tavAresi
متعاهد	mote'Ahed	mote'Ahed
اطعمه	'at'ame	'at'ame
خبال	xabAl	xabAl
